NO ./cub_files/textures/no_redbrick.xpm

SO ./cub_files/textures/so_redbrick.xpm

WE ./cub_files/textures/we_redbrick.xpm

EA ./cub_files/textures/ea_redbrick.xpm


F 225,0,50
C 0,225,50

1111111111111111111111111111111111111111
1000000000000000000000000000000000000001
1000000000000000000000000000000000000001
1000000000100000000000000010000000000001
1000000000100000000000000010000000000001
1000000000100100000000010010000000000001
1000000000100000000000000010000000000001
10000000001000000N0000000010000000000001
1000000000100000000000000010000000000001
1000000000100000010000000010000000000001
100000000010100000000100010000000000001
1000000000100000000000000010000000000001
1000000000100000000000000010000000000001
1000000000000000000000000000000000000001
1000000000000000000000000000000000000001
1000000000000000000000000000000000000001
1111111111111111111111111111111111111111
