NO ./cub_files/textures/no_redbrick.xpm

SO ./cub_files/textures/so_redbrick.xpm

WE ./cub_files/textures/we_redbrick.xpm

EA ./cub_files/textures/ea_redbrick.xpm


F 225,0,50
C 0,225,50

111111111111111111111111111
100000000000000000000000001
100000010000000000000001001
100000010000000000000001001
1000000100000000N0000001001
100000010000000000000001001
100000010000000000000001001
100000000000000000000000001
111111111111111111111111111
