NO ./cub_files/textures/Brick_Wall_Cracked_NO.xpm

SO ./cub_files/textures/Brick_Wall_Cracked_SO.xpm

WE ./cub_files/textures/Brick_Wall_Cracked_WE.xpm

EA ./cub_files/textures/Brick_Wall_Cracked_EA.xpm

F 153,92,45
C 0,0,0

		1111111111111111111111111
		1000000000110000000000001
		1011000001110000000000001
		1001000000000000000000001
11111111101100000111000000000001
100000000011000001110111111111111
11110111111111011100000010001
1111N111111111011101010010001
11000000110101011100000010001
1000W000000000001100000010001
10000000000000001101010010001
1100000111010101111101111000111
11110111 1110101 101111010001
11111111 1111111 111111111111
